RRRPRRPRPPPPPPPPPPPPPPPPPPPPPPPPPPPPPPPPPPPPPPPPPPPPPPPPPPPPPPPPPPPPPPPPPPPPPPPPPPPPPPPPPPPPPSSSSSSSSSSSSSSSSSSSSSSSSSSSSSSSSSSS
RRPRPPPPPPPPPPPPPPPPPPPPPPPPPPPPPPPPPPPPPPPPPPPPPPPSSSSSSSSSSSSSSSSSSSSSSSSSSSSSSSSSSSSSSSSSSSSSSSSSSSSSSSSSSSSSSSSSSSSSSSSSSSSS
RRRPRRRPRRRPRRRPRRRPRRRPRRRPRRRPRRRPRRRPRRRPRRRPRRRPRRRPRRRPRRRPRRRPRRRPRRRPRRRPRRRPRRRPRRRPRPRPPPPPPPPPPPPPPPPPPSSSSSSSSSSSSSSS
RRRPRRRPRRRPRRRPRRRPRRRPRRRPRRRPRRRPRRRPRRRPRRRPRRRPRRRPRRRPRRRPRRRPRRRPRRRPRRRPRPPPPPPPPPPPPPPPPPPPPPPPPPPPPSSSSSSSSSSSSSSSSSSS
RRRPRRRPRRPRPPSSSSSSSSSSSSSSSSSSSSSSSSSSSSSSSSSSSSSSSSSSSSSSSSSSSSSSSSSSSSSSSSSSSSSSSSSSSSSSSSSSSSSSSSSSSSSSSSSSSSSSSSSSSSSSSSSS
RRRPRRRPRRRPRRRPRRRPRRRPRRRPRRRPRRRPRRRPRRRPRRRPRRRPRRRPRRRPRRRPRRRPRRPRPPPPPPPPPPPPPPPPPPPPPPPPPPPPPPSSSSSSSSSSSSSSSSSSSSSSSSSS
RRRPRRRPRRRPRRRPRRRPRRRPRRRPRRRPRRRPRRRPRRRPRRRPRRRPRRRPRRRPRRRPRRRPRRRPRRRPRRRPRRRPRRPRPPPPPPPPPPPPPPPPPPPPPPPPPPSSSSSSSSSSSSSS
RRRPRRRPRRRPRPPSSSSSSSSSSSSSSSSSSSSSSSSSSSSSSSSSSSSSSSSSSSSSSSSSSSSSSSSSSSSSSSSSSSSSSSSSSSSSSSSSSSSSSSSSSSSSSSSSSSSSSSSSSSSSSSSS
RRRPRRRPRPPPPPPPPPPPPPPPPPPPPPPPPPPPPPPPPPPPPPPPPPPPPPPPPPPPPPPPPPPPPPPPPPPPPSSSSSSSSSSSSSSSSSSSSSSSSSSSSSSSSSSSSSSSSSSSSSSSSSSS
RRRPRRRPRRRPRRRPRRRPRRRPRRRPRRRPRRRPRRRPRRRPRRRPRPRPPPPPPPPPPPPPPPPPPPPPPPPPPPPPPPPPPPPPPPPPPPPPPPPPPPPPPPPPPPPPPPPPPPSSSSSSSSSS
RRRPRRRPRRRPRRRPRRRPRRRPRRRPRRRPRRRPRRRPRRRPRRRPRRRPRRRPRRRPRRRPRRRPRRRPRRRPRRRPRRRPRRRPRRRPRRRPRRRPRRRPRRRPRRRPRRRPRRRPRPRPSSSS
RRRPRRRPRRRPRRRPRRRPRRRPRRRPRRRPRRRPRRRPRRRPRRRPRRRPRRRPRRRPRRRPRRRPRRRPRRRPRRRPRRRPRRRPRRRPRRRPRRRPRRRPRRRPRPPPPPPPPPPPPPPPSSSS
RRRPRRRPRRRPRRRPRRRPRRRPRRRPRRRPRRRPRRRPRRRPRRRPRRRPRRRPRRRPRRRPRRRPRRRPRRRPRRRPRRRPRRRPRRRPRRRPRRRPRRRPRPPPPPPPPPPPPPPPPPPSSSSS
RRRPRRPRPPPPPPPPPPPPPPPPPPPPPPPPPPPPPPPPPPPPPPPPPPPPPPPPPPPPPPPPPPPPPPPPPPPPPPPPPPPPPPPPPPPPPPPPPPPPPPPPPPPPPPPPPPPSSSSSSSSSSSSS
RRRPRRRPRRPRPPPPPPPPPPPPPPPPPPPPPPPPPPPPPPPPPPPPPPPPPPPPPPPPPPPPPPPPPPPPPPPPPPPPPPPPPPPPPPPSSSSSSSSSSSSSSSSSSSSSSSSSSSSSSSSSSSSS
RPPPPPPPPPPPPPPPPPPPPPPPPPPPPPPPPPPPPPPPPPPPPPPPPPPPPPPPPPPPPPPPPPPPPPPPPPPPPPPPPPPPPPPPPPPPPPPPPPPPSSSSSSSSSSSSSSSSSSSSSSSSSSSS
RRRPRRRPRRRPRRRPRRRPRRRPRRRPRRRPRRRPRRRPRRRPRRRPRRRPRRRPRRRPRRRPRRRPRRRPRRRPRRRPRRRPRPRPPPPPPPPPPPPPPPPPPPPPPPPPPPPPPPPSSSSSSSSS
RRRPRRRPRRRPRRRPRRRPRRRPRRRPRRRPRRRPRRRPRRRPRRRPRRRPRRRPRRRPRRRPRRRPRRRPRRRPRRRPRRRPRRRPRRRPRRRPRRRPRRRPRPPPPPPPPPPPPPPPPPPPPPSS
RRRPRRRPRRRPRRRPRRRPRRRPRRRPRRRPRRRPRRRPRRRPRRRPRRRPRRRPRRRPRRRPRRRPRRRPRRRPRRRPRRRPRRRPRRRPRRRPRRRPRRRPRRRPRPPPPPSSSSSSSSSSSSSS
RRRPRRRPRRRPRRRPRRRPRRRPRRRPRRRPRRRPRRRPRRRPRRRPRRRPRRRPRRRPRRRPRPPPPPPPPPPPPPPPPPPPPPPPPPPPPPPPPPPPPPSSSSSSSSSSSSSSSSSSSSSSSSSS
RRRPRRRPRRRPRRRPRRRPRRRPRRRPRRRPRRRPRRRPRRRPRRRPRRRPRRRPRRRPRRRPRRRPRRRPRRRPRRRPRRRPRPRPPPPPPPPPPPPPPPPPPPPPPPSSSSSSSSSSSSSSSSSS
RRRPRRRPRRRPRRRPRRRPRRRPRRRPRRRPRRRPRRRPRRRPRRRPRRRPRRRPRRRPRRRPRRRPRRRPRRRPRRRPRRRPRRRPRRRPRRRPRRRPRRRPRRRPRRRPRRPRPPSSSSSSSSSS
RRRPRRRPRRRPRRRPRRRPRRRPRRRPRRRPRRRPRRRPRRRPRRRPRRRPRRRPRRRPRRRPRRRPRRRPRRRPRRRPRRRPRRRPRRRPRRRPRRRPRRRPRRRPRRRPRRRPRRRPRRRPRPPS
RRRPRRRPRRRPRRRPRRRPRRRPRRRPRRRPRRRPRRRPRRRPRRRPRRRPRRRPRRRPRRRPRRRPRRRPRRRPRRRPRRRPRRRPRRRPRRRPRPPPPPPPPPPPPPPPPPPPPPSSSSSSSSSS
RRRPRRRPRRRPRRRPRRRPRRRPRRRPRRRPRRRPRRRPRRRPRRRPRRRPRRRPRRRPRRRPRRRPRRRPRRRPRPRPPPPPPPPPPPPPPPPPPPPPPPPPPPPPPPPPPPSSSSSSSSSSSSSS
RRRPRRRPRRRPRRRPRRRPRRRPRRRPRRRPRRRPRRRPRRPRPPPPPPPPPPPPPPPPPPPPPPPPPPPPPPPPPPPPPPPPPPPPPPPPPPPSSSSSSSSSSSSSSSSSSSSSSSSSSSSSSSSS
RRRPRRRPRRRPRRRPRRRPRRRPRRRPRRRPRRRPRRRPRRRPRRRPRRRPRRRPRRRPRRRPRRRPRRRPRRRPRRRPRRRPRRPRPPPPPPPPPPPPPSSSSSSSSSSSSSSSSSSSSSSSSSSS
RRRPRRRPRRRPRRRPRRRPRRRPRRRPRRRPRRRPRRRPRRRPRRRPRRRPRRRPRRRPRRRPRRRPRRRPRRRPRRRPRRRPRRRPRRRPRRRPRRRPRPRPPPPPPPPPPPPPPPPPPPSSSSSS
RRRPRRRPRRRPRRRPRRRPRRRPRRRPRRRPRRRPRRRPRRRPRRRPRRRPRRRPRRRPRRRPRRRPRRRPRRRPRRRPRRRPRRRPRRRPRRRPRRRPRRRPRPPPPPPPPPPPPPPPSSSSSSSS
RRRPRRRPRRRPRRRPRRRPRRRPRPRPPPPPPPPSSSSSSSSSSSSSSSSSSSSSSSSSSSSSSSSSSSSSSSSSSSSSSSSSSSSSSSSSSSSSSSSSSSSSSSSSSSSSSSSSSSSSSSSSSSSS
RRRPRRRPRRRPRRRPRRRPRRRPRRRPRRRPRRRPRRRPRRRPRRRPRRRPRRRPRRRPRRRPRRRPRRRPRPPPPPPPPPPPPPPPPPPPPSSSSSSSSSSSSSSSSSSSSSSSSSSSSSSSSSSS
RRRPRRRPRRRPRRRPRRRPRRRPRRRPRRRPRRRPRRRPRRRPRRRPRRRPRRRPRRRPRRRPRRRPRRRPRRRPRRRPRRRPRRRPRRRPRRRPRRRPRRRPRPPSSSSSSSSSSSSSSSSSSSSS
RRRPRRRPRRRPRPPPPPPPPPPPPPPPPPPPPPPPPPPPPPPPPPPPPPPPPPPPPPPPPPPPPPPPPPPPPPPPPPPPPPPPPPPPPPPPPPPPPPPPPPPPPSSSSSSSSSSSSSSSSSSSSSSS
RRRPRRRPRRRPRRRPRRRPRRRPRRRPRRRPRRRPRRRPRRRPRRRPRRRPRRRPRRRPRRRPRRRPRRRPRRRPRRRPRRRPRRRPRRRPRRRPRRRPRRRPRRRPRRRPRRPRPPPPSSSSSSSS
RRRPRRPRPPPPPPPPPPPPPPPPPPPPPPPPPPPPPPPPPPPPPPPPPPPPPPPPPPPPPPPPPPPPPPPPPPPPPPPPPPPPPPPPPPPPPPPPPPPPPPPPPPPPPPPPPPPPPPPPPPPPSSSS
RRRPRRRPRRRPRRRPRRRPRRRPRRRPRRRPRRRPRRRPRRRPRRRPRRRPRRRPRRRPRRRPRRRPRRRPRRRPRRRPRRRPRRRPRRRPRRRPRRRPRRRPRPRPPPPPPPPPPPPPSSSSSSSS
RRRPRRRPRRRPRRRPRRRPRRRPRRRPRRRPRRRPRRRPRRRPRRRPRRRPRRRPRRRPRRRPRRRPRPPPPPPPPPPPPPPPPPPPPPPPPPPPPPPPPPPPPPPPPPPPPPPPPPPPPPPPPPSS
RRRPRRRPRRRPRRRPRRRPRRRPRRRPRRRPRRRPRRRPRRRPRRRPRRRPRRRPRRRPRRRPRRRPRRRPRRRPRRPRPPPPPPPPPPPPPPPPPPPPPPPPPPPPPPPPPPPPPPPPPSSSSSSS
RRRPRRRPRRRPRRRPRRRPRRRPRRRPRRRPRRRPRRRPRRRPRRRPRRRPRRRPRPRPPPPPPPPPPPPPPPPPPPPPPPPPPPPPPPPPPPPPPPPPPPPPSSSSSSSSSSSSSSSSSSSSSSSS
RRRPRRRPRRRPRRRPRRRPRRRPRRRPRRRPRRRPRPPPPPPPPPPPPPPPPPPPPPPPPPPPPPPPPPPPPPPPPPPPPPPPPPPPPPPPPPPPPSSSSSSSSSSSSSSSSSSSSSSSSSSSSSSS
RRRPRRRPRRRPRRRPRRRPRRRPRRRPRRRPRRRPRRRPRRRPRRRPRRRPRRRPRRRPRRRPRRRPRRRPRPPPPPPPPPPPPPPPPPPPPPPPPPPPPPPPPPPPPPSSSSSSSSSSSSSSSSSS
RPRPPPPPPPPPPPPPPPPPPPPPPPPPPPPPPPPPPPPPPPPPPPPPPPPPPPPPPPPPPPPPPPPPPPPPPPPPPPPPPPPPPPPPPPPPPPPPPPPPPPPPSSSSSSSSSSSSSSSSSSSSSSSS
RRRPRRRPRRRPRRRPRRRPRRRPRRRPRRRPRRRPRPRPPPPPPPPPPPPPPPPPPPPPPPPPPPPPPPPPPPPPPPPPPPPPPPPPPPPPPPPPPPPPPPPPPPPPPSSSSSSSSSSSSSSSSSSS
RRRPRRRPRRRPRRRPRRRPRRRPRRRPRRRPRRRPRRRPRRRPRRRPRRRPRPPPPPPPPPPPPPPPPPPPPPPPPPPPPPPPPPPPPPPPPPPPPPPPPPPPPPPPPPPPPPPPPPSSSSSSSSSS
RRRPRRRPRRRPRRRPRRRPRRRPRRRPRRRPRRRPRRRPRRRPRRRPRRRPRRRPRRRPRRRPRRRPRRRPRRRPRRRPRRRPRPRPPPPPPPPPSSSSSSSSSSSSSSSSSSSSSSSSSSSSSSSS
RRRPRRRPRRRPRRRPRRRPRRRPRRRPRRRPRRRPRRRPRRRPRRRPRRRPRRRPRRRPRRRPRRRPRRRPRPRPPPPPPPPPPPSSSSSSSSSSSSSSSSSSSSSSSSSSSSSSSSSSSSSSSSSS
RRRPRRRPRRRPRRRPRRRPRRPRPPPPPPPPPPPPPPPPPPPPPPPPPPPPPPPPPPPPPPPPPPPPPPPPPPPPPPPPPPPPPPPPPPPPPPPPPPPPPPPPPPPPPPPPPPPSSSSSSSSSSSSS
RRRPRRRPRRRPRRRPRRRPRRPRPPPPPPPPPPPPPPPPPPPPPPPPPPPPPPPPPPPPPPPPPPPPPPPPPPPPPPPPPPPPPPSSSSSSSSSSSSSSSSSSSSSSSSSSSSSSSSSSSSSSSSSS
RRRPRRRPRRRPRRRPRRRPRRRPRRRPRRRPRRRPRRRPRRRPRRRPRRRPRRRPRRRPRRRPRPPPPPPPPPPPPPPPPPPPPPPPPPPPPPPPPPPPPPPPPPPPPPPPPPPPPPPPPPPPPPSS
RRRPRRRPRRRPRRRPRRRPRRRPRRRPRRRPRRRPRRRPRRRPRRRPRRRPRRRPRRRPRRRPRRRPRRRPRRRPRRRPRRRPRRRPRRRPRPRPPPPPPPPPPPPSSSSSSSSSSSSSSSSSSSSS
RRRPRRRPRRRPRRRPRRRPRRRPRRRPRRRPRRRPRRRPRRRPRRRPRRRPRRRPRRRPRPRPPPPPPPPPPPPPPPPPPPPPPSSSSSSSSSSSSSSSSSSSSSSSSSSSSSSSSSSSSSSSSSSS
RRRPRRRPRRRPRRRPRRRPRRRPRRRPRRRPRRRPRRRPRRRPRRRPRRRPRRRPRRRPRRPRPPPPPPPPPPPPPPPPPPPPPPPPPPPPPPPPPPPPPPPSSSSSSSSSSSSSSSSSSSSSSSSS
RRRPRRRPRRRPRRRPRRRPRRRPRRRPRRRPRRRPRRRPRRRPRRRPRRRPRRRPRRRPRRRPRRRPRRRPRRRPRRRPRRRPRRRPRRRPRRRPRRRPRRRPRRPRPPPPPPPPPPPPPPSSSSSS
RRRPRRRPRRRPRRRPRRRPRRRPRRRPRRRPRRRPRRRPRRRPRRRPRRRPRRRPRRRPRRRPRRRPRRRPRRRPRRRPRRRPRRRPRRRPRRRPRRRPRPPPPPPPPPPPPPPPSSSSSSSSSSSS
RRRPRRRPRRRPRRRPRRRPRRRPRRRPRRPRPPPPPPPPPPPPPPPPPPPPPPPPPPPPPPPPPPPPPPPPPPPPPPPPPPPPPPPPPPPPPPPPPPPPPPPPPPPPSSSSSSSSSSSSSSSSSSSS
RRRPRRRPRRRPRRRPRRPRPPPPPPPPPPPPPPPPPPPPPPPPPPPPPPPPPPPPPPPPPPPPPPPPPPPPPPPPPPPPPPPPPPPPPPPPPPPPPPPPPPPPPSSSSSSSSSSSSSSSSSSSSSSS
RRRPRRRPRRRPRRPRPPPPPPPPPPPPPPPPPPPPPPPPPPPPPPPPPSSSSSSSSSSSSSSSSSSSSSSSSSSSSSSSSSSSSSSSSSSSSSSSSSSSSSSSSSSSSSSSSSSSSSSSSSSSSSSS
RRRPRRRPRRRPRRRPRRRPRPPPPPPSSSSSSSSSSSSSSSSSSSSSSSSSSSSSSSSSSSSSSSSSSSSSSSSSSSSSSSSSSSSSSSSSSSSSSSSSSSSSSSSSSSSSSSSSSSSSSSSSSSSS
RRRPRRRPRRRPRRRPRRRPRRRPRRRPRRRPRRRPRRRPRRRPRRRPRRRPRRRPRRRPRPRPPPPPPPPPPPPPPPPPPPPPPPPPPPSSSSSSSSSSSSSSSSSSSSSSSSSSSSSSSSSSSSSS
RRRPRRRPRRRPRRRPRRRPRRRPRRRPRRRPRRRPRRRPRRRPRRRPRRRPRRRPRRRPRRRPRRRPRRRPRRRPRRRPRRRPRPRPPPPPPPPPPPPSSSSSSSSSSSSSSSSSSSSSSSSSSSSS
RPRPPPPPPPPPPPPPPPPPPPPPPPPPPPPPPPPPPPPPPPPPPPPPPPPPPPPPPPPPPPPPPPPPPPPPPPPPPPPPSSSSSSSSSSSSSSSSSSSSSSSSSSSSSSSSSSSSSSSSSSSSSSSS
RRRPRRRPRRRPRRRPRRRPRRRPRRRPRRRPRRRPRRRPRRRPRRRPRRRPRRRPRRRPRRRPRRRPRRRPRRRPRRRPRRRPRRRPRRRPRRRPRRRPRPRPPSSSSSSSSSSSSSSSSSSSSSSS
RRRPRRRPRRRPRRRPRRRPRRRPRRRPRRRPRRRPRRRPRRRPRPPPPPPPPPPPPPPPPPPPPPPPPPPPPPPPPPPPPPPPPPPPSSSSSSSSSSSSSSSSSSSSSSSSSSSSSSSSSSSSSSSS
RRRPRRRPRRRPRRRPRRRPRRRPRRRPRRRPRRRPRRRPRRRPRRRPRRRPRRRPRRRPRRRPRRRPRRRPRRRPRRRPRRRPRRRPRRRPRPPPPPPPPPPSSSSSSSSSSSSSSSSSSSSSSSSS
RRRPRRRPRPRPPPPPPPPPPPPPPPPPPPPPPPPPPPPPPPPPPPPPPPPPPPPPPPPPPPSSSSSSSSSSSSSSSSSSSSSSSSSSSSSSSSSSSSSSSSSSSSSSSSSSSSSSSSSSSSSSSSSS
RRRPRRRPRRRPRRRPRRRPRRRPRRRPRRRPRRRPRRRPRRRPRRRPRRRPRRRPRRRPRPPPPPPPPPPPPPPPPPPPPPPPPPPSSSSSSSSSSSSSSSSSSSSSSSSSSSSSSSSSSSSSSSSS
RRRPRRRPRRRPRPPPPPPPPPPPPPPPPPPPPPPPPPPPPPPPPPPPPPPPPPPPPPPPPPPPPPPPPPPPPPPPPPPPPPPPPPPPSSSSSSSSSSSSSSSSSSSSSSSSSSSSSSSSSSSSSSSS
RRRPRRRPRRRPRRRPRRRPRRRPRRRPRRRPRPRPPPPPPPPPPPPPPPPPPPPPPPPPPPPPPPPSSSSSSSSSSSSSSSSSSSSSSSSSSSSSSSSSSSSSSSSSSSSSSSSSSSSSSSSSSSSS
RRRPRRRPRRRPRRRPRRRPRRRPRRRPRRRPRRRPRRRPRRRPRRRPRRRPRRRPRRRPRRRPRRRPRRRPRRRPRRRPRRRPRRRPRRRPRRRPRRRPRRRPRRRPRRRPRRRPRRRPRRPRPPSS
RRRPRRRPRRRPRRRPRRRPRRRPRRRPRRRPRRRPRRRPRRRPRPPPPPPPPPPPPPPPPPPPPPPPPPPPPPPPPPPPPPPPPPPPPPPPPPPPPPPPPSSSSSSSSSSSSSSSSSSSSSSSSSSS
RRRPRRRPRRRPRRRPRRRPRRRPRRRPRRRPRRRPRRRPRPPPPPPPPPPPPPPPPPPPPPPPPPPPPPPPPPPPPPPPPPPPPPPPPPPPPPPPPPPPPPPPPPPPPPPPPPPPPPPPPPPPSSSS
RRRPRRRPRRRPRRRPRRRPRRRPRRRPRRRPRRRPRRRPRRRPRRRPRRRPRRRPRRRPRRRPRRRPRRRPRRRPRRRPRRRPRRRPRRRPRRRPRRRPRRRPRRRPRRRPRRRPRPPPSSSSSSSS
RRRPRRRPRRRPRRRPRRRPRRRPRRRPRRRPRRPRPPPPPPPPPPPPPPPPPPPPPPPPPPPPPPPPPPPPPPPPPPPPPPPPPSSSSSSSSSSSSSSSSSSSSSSSSSSSSSSSSSSSSSSSSSSS
RRRPRRRPRRRPRRRPRRRPRRRPRRRPRRRPRRRPRRRPRRRPRRRPRPRPPPPPPPPPPPPPPPPPPPPPPPPPPPPPPPPPPPPPPPPPPPPPPPPPPPPPPPPPPPPPPPPPPPSSSSSSSSSS
RRRPRRRPRRRPRRRPRRRPRRPRPPPPPPPPPPPPPPPPPPPPPPPPPPPPPPPPPPPPPPPPPPPPPPPPPPPPPPPPPPPPPPPPSSSSSSSSSSSSSSSSSSSSSSSSSSSSSSSSSSSSSSSS
RRRPRRRPRRRPRRRPRRRPRRRPRRRPRRRPRRPRPPPPPPPPPPPPPPSSSSSSSSSSSSSSSSSSSSSSSSSSSSSSSSSSSSSSSSSSSSSSSSSSSSSSSSSSSSSSSSSSSSSSSSSSSSSS
RRRPRRRPRRRPRRRPRRRPRRRPRRRPRRRPRRRPRRRPRRRPRRRPRRRPRRRPRRRPRRRPRRRPRRRPRRRPRRRPRRRPRRRPRRRPRRRPRRRPRRRPRRPRPPPPPPPPPPPPSSSSSSSS
RRRPRRRPRRRPRRRPRRRPRRRPRRRPRRRPRRRPRRRPRRRPRRRPRRRPRRRPRRRPRRRPRRRPRRRPRRRPRRRPRRRPRRRPRRRPRPRPPPPPPPPPPPPPPPPPPPPPPPPSSSSSSSSS
RRRPRRRPRRRPRRRPRRRPRRRPRRRPRRRPRRRPRRRPRRRPRRRPRRRPRRRPRRRPRRRPRRRPRRRPRRRPRRPRPPPPPPSSSSSSSSSSSSSSSSSSSSSSSSSSSSSSSSSSSSSSSSSS
RRRPRRRPRRRPRRRPRRRPRRRPRRRPRRRPRRRPRRRPRRRPRRRPRRRPRRRPRRRPRRRPRRRPRRRPRPRSSSSSSSSSSSSSSSSSSSSSSSSSSSSSSSSSSSSSSSSSSSSSSSSSSSSS
RRRPRRRPRRRPRRRPRRRPRRRPRRRPRRPRPPPPPPPPPPPPPPPPPPPPPPPPPPPPPPPPPPPPPPPPPPPPPPPPPPPPPPPPPPPPPPPPPPPPPPPPPPPPPPPPPPPPPSSSSSSSSSSS
RRRPRRRPRRRPRRRPRRRPRRRPRRRPRRRPRRRPRRRPRRRPRRRPRRRPRRRPRRRPRRRPRPRPPPPPPPPPPPPPPPPPPPPPPPPPPPPPPPPPPPPPPPPSSSSSSSSSSSSSSSSSSSSS
RRRPRRRPRRRPRRRPRRRPRRRPRRRPRRRPRRRPRRRPRRRPRRRPRRRPRRRPRRRPRRRPRRRPRPPPPPPPPPPPPPPPPPPPPPPPPPPSSSSSSSSSSSSSSSSSSSSSSSSSSSSSSSSS
RRRPRRRPRRRPRRRPRRRPRRRPRRRPRRRPRRRPRRRPRRRPRRRPRRRPRRRPRRRPRRRPRRRPRRRPRRPRPPSSSSSSSSSSSSSSSSSSSSSSSSSSSSSSSSSSSSSSSSSSSSSSSSSS
RRRPRRRPRRRPRRRPRRRPRRRPRRRPRRRPRRRPRRRPRRRPRRRPRRRPRRRPRRRPRRRPRRRPRRRPRRRPRRRPRRRPRRRPRRRPRRRPRRRPRRRPRRRPRRRPRRRPRRRPRRPRPPPS
RRRPRRRPRRRPRRRPRRRPRRRPRRRPRRRPRRRPRRRPRRRPRRRPRRRPRRRPRRRPRRPRPPPPPPPPSSSSSSSSSSSSSSSSSSSSSSSSSSSSSSSSSSSSSSSSSSSSSSSSSSSSSSSS
RRRPRRRPRRRPRRRPRRRPRRRPRRRPRRRPRRRPRRRPRRRPRRRPRRRPRRRPRRRPRRRPRRRPRRRPRRRPRPRPPPPPPPPPPPPPPPPPPPPPPPSSSSSSSSSSSSSSSSSSSSSSSSSS
RRRPRRRPRRRPRRRPRRRPRRRPRRRPRRRPRRRPRRRPRRRPRRRPRRRPRRPRPPPPPPPPPPPPPPPPPPPPPPPPPPPPPPPPPPPPPPPPPPPPPPPPPPPPPPPPPPPPPPPPPPPPPPSS
RRRPRRRPRRRPRRRPRRRPRRRPRRRPRRRPRRRPRRRPRRRPRRRPRRRPRRRPRPPPPPPPPPPPPPPPPSSSSSSSSSSSSSSSSSSSSSSSSSSSSSSSSSSSSSSSSSSSSSSSSSSSSSSS
RRRPRRRPRRRPRRRPRRRPRRPRPPPPPPPPPPPPPPPPPPPPPPPPPPPPPPPPPPPPPPPPPPPPPPPPPPPPPPPPPPPPPPPPPPPPPPPPPPPPPPPPPPPPPPPPPPPSSSSSSSSSSSSS
RRRPRRRPRRRPRRRPRRRPRRRPRRRPRRRPRRRPRRRPRPPPPPPPPPPPPPSSSSSSSSSSSSSSSSSSSSSSSSSSSSSSSSSSSSSSSSSSSSSSSSSSSSSSSSSSSSSSSSSSSSSSSSSS
RRRPRRRPRRRPRRRPRRRPRRRPRRRPRRRPRRRPRRRPRRRPRRRPRRRPRRRPRRRPRRRPRRRPRRRPRRRPRRRPRRRPRRRPRPPPPPPPPPSSSSSSSSSSSSSSSSSSSSSSSSSSSSSS
RRRPRRRPRRRPRRRPRPPPPPPPPPPPPPPPPPPPPPPPPPPPPPPPPPPPPPPPPPPPPPPPPPPPPPPPPPPPPPPPPSSSSSSSSSSSSSSSSSSSSSSSSSSSSSSSSSSSSSSSSSSSSSSS
RRRPRRRPRRRPRRRPRRRPRRPRPPPPPPPPPPPPPPPPPPPPPPPPPPPPPPPPPPPPPPPPPPPPPPPPPPPPPPPPPPPPPPPPPPPPPPPPPPPPPPPPPPPPPPPPPPPSSSSSSSSSSSSS
RRRPRRRPRRRPRRRPRRRPRRRPRRRPRRRPRRRPRRRPRRRPRRRPRRRPRRRPRRRPRRRPRRRPRRRPRRRPRRRPRRRPRPRPPPPPPSSSSSSSSSSSSSSSSSSSSSSSSSSSSSSSSSSS
RRRPRRRPRRRPRRRPRRRPRRRPRRRPRPRPPPPPPPPPPPPPPPPPPPPPPPPPPPPPPPPPPPPPPPPPPPPPPPPPPPPPPPPPPPPPPPPPPPPPPPPPPPPPPPPSSSSSSSSSSSSSSSSS
RRRPRRRPRRRPRRRPRRRPRRRPRRRPRRRPRRRPRRRPRRRPRRRPRRRPRRRPRRRPRRRPRRRPRRRPRRRPRPRPPPPPPPPPPPPPPPPPPPPPPPPPPPPPPPPPPPPPPPPPPPPPPPSS
RRRPRRRPRRRPRRRPRRRPRRRPRRRPRRRPRRRPRRRPRRRPRRRPRRRPRRRPRRRPRRRPRRRPRRRPRRRPRRRPRRRPRRRPRRRPRRRPRRRPRRRPRRRPRRRPRPSSSSSSSSSSSSSS
RRRPRRRPRRRPRRRPRRRPRRRPRRRPRRRPRRRPRRRPRRRPRRRPRRRPRRRPRRRPRRRPRRRPRRRPRRRPRRRPRRRPRRRPRRRPRRRPRRRPRRRPRPRPPPPPPPPPPPPPPSSSSSSS
RRRPRRRPRRRPRRRPRRRPRRRPRRRPRRRPRRRPRRRPRRRPRRRPRRRPRRRPRRRPRRRPRRRPRRRPRRRPRRRPRRRPRRRPRRRPRRRPRRRPRPPPPPPPPPPPPSSSSSSSSSSSSSSS
