PRRSRRSSRRRRRSRRPRRRRSRRSSSSPRRR
RPPPPPPPPPPPPPSSSSSSSSSSSSSSSSSS
PRRRRSRRRPSPRPRRRRRRRRRRRPRRRRRR
RRRPPPPSSSSSSSSSSSSSSSSSSSSSSSSS
PRRRRRRRRRRRSRRRRSPRRRRRRPSPRRRP
RRRRRRPPPPPPPSSSSSSSSSSSSSSSSSSS
RRPRRRRRRSRRRRRRPRRRRRRRSSRPRRPR
PRSRRPRRRPSRSRRRRRPPPPPSRRPPSSRR
SPRRRRRRRRPSRSRPRSPRRSRSSPPPRSRP
PSPRRRPRRSRRRPRRPRRRRRRPRRPRRPRS
RPPPPPPPPPPPPPPPPPSSSSSSSSSSSSSS
RRRPPPPPSSSSSSSSSSSSSSSSSSSSSSSS
SSSSSSSSSSSSSSSSSRRPSRRSSSSRSRRR
RPRPRPRRRSPSRRRRRRRPPRRRPPPSRRRP
RRRRRRRRRRRRPRRRSSRPRRRPRRRRRPRR
RRRRRRRRRPPPPPPPPPPPPPSSSSSSSSSS
RRSRSRRSSRRRRPRRSSSSSSSSSSSSSSSS
RRRRRRRRRRRPPPPPPPPPPPPPPPPPPPSS
RRRPPPPPPPPPPPPSSSSSSSSSSSSSSSSS
RRRSRRPRRRRRRSRRPRRRRPSSRRPRRRRR
RRRRRRRRRRPPPPPPPPPPPPPPPPPPSSSS
RSRSRSRPSSRSRSRRRRRPSRRRSRPRPSPR
SSSSSRPRRSRRSRRPRSRSSRPRRRRRRRRR
RRRRRRRRRRRRPPPPPPPPPPPPPPPPPPPS
PRPRPPRRRRRRRPPSRPRPPRPSRRRPRPRP
RRRRPRSRRRRRRRRRRRRPRRSRRPRRSSSS
RRRRRRRRRRRRRRPPPPPPPPPPPPPPSSSS
RPPRRPRRRRRRRRPPPRRRPRRRRRRPSPPR
RRRRRRRRRRRPPPPPPPPPPPPPPPSSSSSS
RRRRRRRRRRRRRRPPPPPPPSSSSSSSSSSS
RSRRSRPPSRRSRRRRRSRPSPRSRPRRSSSS
RRRRSPSRSRRRRRPRPRSSRSPRRSRRPRRR
RRRRRRRRRPPPPPPPSSSSSSSSSSSSSSSS
RRPRSRRRRSPRSSSSRRPRRRRSSRSRRSRR
RRRRRRRRRRRRRRRPPPPPPPPPPPPPPSSS
RRRRRPPPPPPPPPPPPPPPPPPPPPPSSSSS
RRRRRPPPPPPPPPPPPPPPPPSSSSSSSSSS
RRRRRRRRRRPPPPPPPPPPPPPPPPPPPPPS
SPRPRPRRRPPPSPPRPPRPPRRRRRPRRRRS
RRRRSRRRRRSRSRPRRPSSSSSSSRRRRRPR
RRRRRRRRRRRRRRRPSSSSSSSSSSSSSSSS
RRRRRRRRRRRPPPPPPPPPPPPPPPPPPPPS
SSRPRPRSSRPRRRRSRPRRRRRRRSSRRRPS
RRRSSRRPSRRSRRRSPSRSRSPRPRRRSSSS
RRRRPRRRRPRRRRSRRRPPRRRRSSSPSRRP
RRRRRRRRRRRPSRRSRRRRRPRRSSSSSSSS
RRRRRRRRRRRRRRRPPPPPSSSSSSSSSSSS
RRPPPPPPPPPPPPPPPPPPPPSSSSSSSSSS
RRRRRRRRRRRRRPPPSSSSSSSSSSSSSSSS
SPPPPRRRRRRRRRPPRSPRPRRRRRRPRRSR
