RRRPRRRPRRRPRRRPRRRPRRRPRPSSSSSS
RRRPRRRPRRRPRRRPRRRPRRRPRRRPRPPS
RRRPRRRPRRRPRRRPRRRPRRRPRPRSSSSS
RRRPRRRPRRRPRRRPRRRPRRPRPPPPPPPS
RRRPRRRPRRRPRRRPRPPPPPPPPPPPPPSS
RRRPRRRPRRRPRRRPRRRPRRRPRRRPRPPS
RRRPRRRPRRRPRPRPPPPPPPSSSSSSSSSS
RPRPPPPPPPPPPPPPPPPSSSSSSSSSSSSS
RPRPPPPPPPPPPPPPPPSSSSSSSSSSSSSS
RRRPRRPRPPPPPSSSSSSSSSSSSSSSSSSS
RRRPRRRPRRRPRRRPRRRPRPRPPPPSSSSS
RRRPRRRPRRRPRRRPRPPPPPPPPPPSSSSS
RPRPPPPPSSSSSSSSSSSSSSSSSSSSSSSS
RRRPRRRPRRRPRRRPRRRPRPPPPPPSSSSS
RRRPRRRPRRRPRRRPRRRPRRRPRPRSSSSS
RRRPRPRPPPPPPPPPPPSSSSSSSSSSSSSS
RRPRPPPPPPPSSSSSSSSSSSSSSSSSSSSS
RRRPRRRPRRRPRRPRSSSSSSSSSSSSSSSS
RRRPRPRPPPPPPPPPPPPPPPPPPPPPPSSS
RPPPPPPPPPPPPPPPPPPPPPPSSSSSSSSS
RRRPRRRPRRRPRRRPRRRPRRRPRRPRPPSS
RRRPRRRPRRRPRRRPRRRPRRPRPPPSSSSS
RRRPRPRPPSSSSSSSSSSSSSSSSSSSSSSS
RRRPRRRPRPRPPPSSSSSSSSSSSSSSSSSS
RPPPPPPPPPPPPPPPPPPPPPPPPPPPPSSS
RRRPRRRPRRRPRRRPRPRPPPPPPSSSSSSS
RRRPRRRPRRRPRPPPPPSSSSSSSSSSSSSS
RRPRPPPPPPPPPSSSSSSSSSSSSSSSSSSS
RRRPRRRPRRRPRRRPRRRPRRRPRPPSSSSS
RRRPRRRPRRRPRPRPPPPPPPPPSSSSSSSS
RRRPRRRPRRRPRRRPRPPPPPPPPPPPPSSS
RRRPRRPRPPPSSSSSSSSSSSSSSSSSSSSS
RRRPRRRPRRRPRRRPRRRPRPRPPPPPSSSS
RRRPRPPPPPPPPPPPPPPPPPSSSSSSSSSS
RRRPRRRPRRRPRRRPRRRPRRRPRPPPPPPS
RRRPRRRPRPRPPPPPPPPPPPPPPPPSSSSS
RRRPRRRPRRRPRRRPRRRPRPRPPPPPPSSS
RRRPRRRPRRRPRRRPRPRPPSSSSSSSSSSS
RRRPRRRPRRRPRRRPRRPRPPPPPPSSSSSS
RRRPRRRPRRRPRRRPRRRPRRRPRPPPPPSS
RRRPRRRPRRRPRPRPPPPPPPPPSSSSSSSS
RRRPRRRPRPPPPPPSSSSSSSSSSSSSSSSS
RPRPPPPPPPPPPPPPPPPSSSSSSSSSSSSS
RRRPRRRPRRRPRRRPRRPRPPSSSSSSSSSS
RRRPRRRPRRRPRRRPRPRPPPPSSSSSSSSS
RRRPRPRPPPPPPPSSSSSSSSSSSSSSSSSS
RRRPRRRPRPRPSSSSSSSSSSSSSSSSSSSS
RRRPRRRPRRRPRRRPRRPRPPPSSSSSSSSS
RRRPRRRPRRRPRRRPRRPRPPPPPPPPPPSS
RRRPRRRPRRRPRRPRSSSSSSSSSSSSSSSS
