RRPSRRPRSRSSRRSRRRRPRPSSPRRSRPSR
RRRRRRRRRRRRPPPPPPPPSSSSSSSSSSSS
RSPRRRRRRSRRRRRRRRRRRRPRSSSSSSSS
PSPRRRPRRRRPRPPRRRRRRRPPRRRRRRPR
RRPRRRSSRPRPRRRRRRPRPSRSSSRPPSPR
RRPPRRRRPPRRRPSPRRSRSRPRRRPRRRRP
PSRPPRRPRRRRRRRPRRRRRRRPRRRRRRRR
RRPPPPPPPPPPPPPPPPPSSSSSSSSSSSSS
PRRRRRRRPRPRSSPRRRPRPPRPPPRRRRRR
RPRRSRPRRRSRPRRSRRRRRPPRSSSSPRRP
RSRPSSRSSSSSRPRRPRSRRRRRRRRRSRSS
RRRRRRRRRRRPPPPPPPPPPPPPPSSSSSSS
RRRRRRRRRRRRPPPPPPPPPPPPPPSSSSSS
RRRPSRRRRRRRRRRRSSSSRRRPRRRRRPRR
RRPRRRRRPRPSRPRRRPRRRRRRRRRRRRRR
RSRSRSRRRRPRSRRPPSPRRPRRSPPRRPSR
SRRRRRRRRRRRRRRPSSSSSSSSRPRRRRSS
RRRSRRRPRRPRSSSSPRRRRRRRRRRRRRRR
RPRPRRRRRPSPPRRPRRRRRPRRRRRRRRPR
RRRRRRRRPRRRPRPRRPRRRRRRRPRSSSRP
RRRRRPPPPPPPPPPPSSSSSSSSSSSSSSSS
RRPRSRRRSRRRRRRRSSSPRRRPPRRRRPRR
RRRRRRRRRPPPPPPPPSSSSSSSSSSSSSSS
RSRRRRRPPPRPPSPRPRPRRRRRRRRRRRRR
RRRRRRRRRRRPPPPPPPPSSSSSSSSSSSSS
RPRRSRRRRSPRRPSPRRSRPRRSSSRSRSRR
RRRRRRRRRRPPPPPPPPSSSSSSSSSSSSSS
RRRPPPPPPPPPPSSSSSSSSSSSSSSSSSSS
RRPRRSSRPRSSSSSSRSSRSRRRRPRRRSRR
RRRRRRRSRSSRRRPRRRPRRPSSRPRRRSSR
RRRRRPPPPPPSSSSSSSSSSSSSSSSSSSSS
RRRRPRRRRRRRRRRRSSSSSSSSRPRRRRRR
RRPRRRRRPSSSPRSSRRRSPRRSRSSSRRSR
RRRRRRRRRRRRRRPPPPPPPPPSSSSSSSSS
RPPPPPPPPPPPPPPPPPPPPPPPPPPPPPPS
RPRRRRRRRPPRRPSPSRRRRRRPRRRRRRRR
SRPRSSSRSSSRSRSSSSSSSSSSSSSSSSSS
RRPPPPPPPPPSSSSSSSSSSSSSSSSSSSSS
RSRPRRRRPSSSRRRSPRRSPRSSRRPRSSRR
PRSPPRRRRRRRRRPPRRRRRRSRRRRRRPRP
RRRRRRRRRRRRRRRPPPPPPPPPPPPPPSSS
RRRRRRRPPPPPPPPPPPPPPSSSSSSSSSSS
RRRRRRRRPRRPPRRRRRPRPPSPPRPPPRRR
RRRRRRRRRRRPPPPPPPPPPPPPPPSSSSSS
RRSSRRPRSSSSRPRRRPRRSRRRSRRSRRRR
RSRRRRRRPRRRRRRRRRPRSRRRSSSSPRRR
SRPRSSRSSSRSSRRSSSSSSSSSRRPRSSSR
RRRRRPRRRPPSSRPRRRPRRRPRRSRRRRRR
RPPPPPSSSSSSSSSSSSSSSSSSSSSSSSSS
RRRRRRRRRRRRRPRRSSSSSSSSRRRRPRRR
